      _
     (_)
    <___>
     | |___________________________________________
     | |`-._`-._         :|    |:         _.-'_.-'|
     | |`-._`-._`-._     :|    |:     _.-'_.-'_.-'|
     | |    `-._`-._`-._ :|    |: _.-'_.-'_.-'    |
     | | _ _ _ _`-._`-._`:|    |:`_.-'_.-' _ _ _ _|
     | |------------------      ------------------|
     | |                                          |
     | |__________________      __________________|
     | |- - - - -_.--_.--:|    |:--._--._- - - - -|
     | |     _.-'_.-'_.-':|    |:`-._`-._`-._     |
     | | _.-'_.-'_.-'    :|    |:    `-._`-._`-._ |
     | |'_.-'_.-'        :|    |:        `-._`-._`|
     | |~~~~~~~~~~~~~~~~~~~~~~~~~~~~~~~~~~~~~~~~~~~
     | |
     | |
     | |
     | |
     | |
     | |