#####(((#(#(#((###(((((((((((((((((((((((((//((//,*.*((#((((((((((((((((###((((((((((((######(((((((
#############(((((###((((((((((((((((((((((( .*..(** //. ((((((((((((((((##(#((((((##########(((####
#################((((((((((((((((((((((((/(/(////////((/(//(((((((((((((((((((##(((#################
######(########((((#(,,*,,,*,.,,*,,.,,**(/(((((#(((((((/##(,//*,*,**,*,*/,***/*,#(#######(((########
#############(###((((((((((/(((((//(((((//(((((##(#((((##((/(((((((((((((/((((((((##################
##################*,******,*(**//**/***/**/***(**//**/***/**//,,/*,,/***/*,//,,*,,(#################
####################(#(###########(##(#######(###%#############################((###################
####################*(*.......,*/,.......,//,....,.....,*/,...,,..*//,...,,..,*/*###################
#####################(/.,,.  ..#(/,,  ....((*..........*#(*.... .*/((.   ..,*(((####################
.,,,./###############(/,*,.. (##(/*,./####((*.########*%#(/####..%#####*. .(&(#(###############/,,*,
,*,,,,...,,.*//////./((,**,, ##((/**.(#####(*,########/%#((####,*%(((##(,./#&(((.,*//////,,,..,,***/
..,.. .,,,,.,,((((,./(/,*.., ###(/*..######(*,########(%((/####,/%(####(,,/(&(#( ,(##(#(#*/((* . ,#*
.,,.. .,  .,     (,.(((,/*,..###(/**.(####((*,########(%##/####,/&((((#(,*(#&/((*,((    .(   (# ,*##
,,,,, ,,  ., .   (*.(((,***,. .#((**,....*((/*#########%#(*#/../&%(#(,. (/##&(((*/(( .. ,(*. (( */##
..,,, ,,  ., .   *,./(/,****.  #(/***. ..*#(/*((##((#(#%(/*.. .(%%(((,,.#(##&/(/,/(( .//,(*  ##.*/##
.,,,. .,  .. .   ,. ((/,****.  #(/***. ..*#(*/ ..(/(*./%((* ..%#%%(((,..%(##&(((*/(/* /*/(,  (/.*/(#
..,,. ..  .. . . .. ///.***,   (/***,.. .*(/,*((#,.,*//#(/*,,,.(%%/((,.*#(##%(((*/(/*.*,.(/* ((.,/(#
   .  ..  .. . ......**,,,,***///*,,***/*******//*/*///**********/*/*******/,,*/**///,***//,,(,, ./*
.,,,,,,*,,,,*****/***//////////////////////////////////////////////*/*////////**************,,,,****


