                                                                                          
                                                                                          
                                                                                          
                                        &@@@@@@@@@@@@@@@@                                 
                                  /@@@@                 @@@@                              
                               @@@&        ,@@@@   .@@@@@@@                               
                            @@@@           %@@@@&%@@@@@% /@@.                             
                          @@@@                              @@@                           
                         @@@.                                 @@@                         
                       .@@@                                .%@@@@@@                       
                       @@@@                          @@@&     ,/,                         
                      %@@@                        @@@   @@@      @@@&                     
                      @@@@                      @@@   @@@                                 
                      %@@@                     @@@   @@@    @@@@&@@@                      
                       @@@@                   *@@@   @@@    %&@@@ /@                      
                       .@@@&                  @@@@   @@@            @.                    
                        ,@@@#                  @@@   @@@             &#                   
                          @@@&            @@@@ @@@   @@           @@@&                    
                           @@@@         @@@@   @@@@@@             @@                      
                            .@@@  ,@@@@  .@@@@@@@@@                @                      
                          @@  @@@     .@@@      @@@              @@                       
                         @@    %@@      @@@     @@@              .@                       
                        @@@     @@      (@@@    @@%   @@@@@@@@@@@                         
                        .@@,    /@      /@@@   @@,   @#                                   
                          @@@. /@       @@@  &@/     @@                                   
                   @        @@@@@&     @@@@@         @@#                                  
                    @@@               @@@     #@@@@@@#(%@                                 
                      &@@*@@@*    @@@@(   @@@@,    (@@@@@&                                
                         @@@@@@@@/     @@@@    @@@       @@@                              
                         %@@       ,@@@@    @@@         #@@                               
                             &@@@&.       @@@,    (@@@&                                   
                                         @@@                                              
                                         @@@   #@@#                                       
                                          @@    @@@                                       
                                             */                                           
                                                                                          