 _                _       __   __ _____  _   _ 
| |              (_)      \ \ / /|_   _|| | | |
| |  ___   _   _  _  ___   \ V /   | |  | | | |
| | / _ \ | | | || |/ __|  /   \   | |  | | | |
| || (_) || |_| || |\__ \ / /^\ \ _| |_ \ \_/ /
|_| \___/  \__,_||_||___/ \/   \/ \___/  \___/ 
                                               
