########  ########   #######  #### ########    ########  ########    ##     ##  #######  ######## ######## 
##     ## ##     ## ##     ##  ##     ##       ##     ## ##          ##     ## ##     ##    ##    ##       
##     ## ##     ## ##     ##  ##     ##       ##     ## ##          ##     ## ##     ##    ##    ##       
##     ## ########  ##     ##  ##     ##       ##     ## ######      ##     ## ##     ##    ##    ######   
##     ## ##   ##   ##     ##  ##     ##       ##     ## ##           ##   ##  ##     ##    ##    ##       
##     ## ##    ##  ##     ##  ##     ##       ##     ## ##            ## ##   ##     ##    ##    ##       
########  ##     ##  #######  ####    ##       ########  ########       ###     #######     ##    ########
