 __   _____  _____  _____            __   _____    ___  _____ 
/  | |  _  ||____ ||  _  |          /  | |  _  |  /   ||  ___|
`| | | |_| |    / /| |_| |  ______  `| | | |_| | / /| ||___ \ 
 | | \____ |    \ \\____ | |______|  | | \____ |/ /_| |    \ \
_| |_.___/ /.___/ /.___/ /          _| |_.___/ /\___  |/\__/ /
\___/\____/ \____/ \____/           \___/\____/     |_/\____/
                                                             
