      
  ▓▓                                                                                           
  ██                                                                                           
  ██                                                                                         
  ██                                                                                
  ██                                                                                   
  ██                                                                                                                                                                                    
  ██                                                                                                                                                                                                                                                                             
  ██                                                                                                           
  ██                                                                                 
  ██                                                                                                                                                      
  ██                                                                                                                                                      
  ██                                                                                          ▒▒                                                          
  ██                                                                                        ▒▒░░                                                          
  ██                                                                                      ▒▒                                                              
  ██                                                                                    ██                                                                
  ██                                                                                  ██                                                                  
  ██                                  ░░    ░░      ░░    ░░                        ██                                                                    
  ██                                  ░░    ░░      ░░    ░░                      ██                                                                      
  ██                                        ░░            ░░                    ██                                                                        
  ██                                        ░░              ░░░░░░░░░░░░░░    ██                                                                          
  ██                                        ░░      ░░░░░░░░░░░░░░░░░░  ░░  ██                                                                            
  ██                                        ░░                        ░░  ██                                                                              
  ██                                  ░░                            ░░  ██                                                                                
  ██                                                              ░░  ██                                                                                  
  ██                                                                ██                                                                                    
  ██                                                              ██                                                                                      
  ██                                                            ██                                                                                        
  ██                                                        ▒▒              ░░  ░░░░      ░░    ░░                                                        
  ██                                                      ▒▒▒▒                                                    ░░▒▒░░                                  
  ██                                                    ░░▒▒                ░░                                  ░░░░▒▒░░                                  
  ██                                                  ▒▒▒▒                                      ░░          ▒▒▒▒▒▒░░                                      
  ██                                                ██▓▓                                                ░░▒▒▓▓░░                                          
  ██                                              ██                                                ████        ░░            ░░                          
  ██                                            ██                                              ░░▓▓░░          ░░            ░░                          
  ██                                          ▓▓░░                                        ░░░░▒▒▒▒░░  ░░      ░░░░      ░░  ░░░░                          
  ██                                        ░░▒▒                                      ░░░░▓▓▒▒▒▒░░    ░░              ░░            ░░                    
  ██                                      ▒▒▒▒                                    ░░░░▒▒▓▓▒▒░░        ░░    ░░      ░░░░░░░░░░      ░░                    
  ██                                    ██░░                                  ░░░░████▒▒░░            ░░    ░░          ░░░░░░░░░░░░░░                    
  ██                                  ██                                      ▓▓▓▓                    ░░    ░░      ░░    ░░                              
  ██                                ▓▓                                    ████░░                      ░░    ░░      ▒▒▓▓▓▓▓▓                              
  ██                              ▓▓░░                                ▓▓▓▓░░░░                        ░░      ░░▓▓▓▓▒▒░░░░░░                              
  ██                            ▒▒▒▒                              ▒▒▓▓▒▒                            ░░  ░░▓▓▒▒▒▒▒▒  ░░                                    
  ██                          ░░░░                            ░░░░░░░░                              ▒▒▒▒██▓▓░░░░                                          
  ██                        ██░░                          ▒▒▒▒░░                              ░░▒▒██▒▒░░                                                  
  ██                      ██                          ██▓▓                                ████▒▒                                                          
  ██                    ██                        ████                              ██████  ░░                                                            
  ██                  ██                      ████                            ██████                                ░░██████▓▓                            
  ██                ▒▒▒▒                  ▒▒▒▒▒▒                        ▒▒▒▒▒▒▒▒▒▒                            ▓▓▒▒▒▒▒▒▒▒▒▒▒▒▒▒                            
  ██              ▓▓▒▒                ▒▒░░▒▒░░                    ▒▒▒▒░░░░░░                          ▒▒▒▒▒▒▒▒▒▒░░░░░░░░░░░░░░                            
  ██            ▓▓                ▒▒██                      ▓▓▓▓██░░░░                        ░░▓▓▓▓██░░░░░░░░░░░░░░░░  ░░                                
  ██          ██░░            ██▓▓░░                  ██▓▓▒▒░░░░░░                      ██▓▓▓▓▓▓░░░░░░  ░░░░░░  ░░      ░░                                
  ██        ██            ████                  ██████                          ████████      ░░░░░░            ░░      ░░                                
  ██      ██          ████                ██████                        ████████                                ░░      ░░                                
  ██    ▒▒░░      ▒▒▒▒▓▓░░          ▒▒▒▒░░░░░░░░                ▒▒▒▒▒▒▒▒  ░░░░░░                                ░░      ░░                                
  ██  ██      ████            ██████                    ████████                                                ░░    ░░░░                                
  ░░  ░░  ▓▓██░░░░      ▓▓▓▓▓▓░░░░░░            ██▓▓▓▓██░░░░░░                                                        ░░                                  
          ░░░░    ██▓▓▓▓░░░░░░          ██▓▓▓▓▓▓░░░░░░                                            ░░    ░░            ░░                                  
            ██████              ████████                                                        ░░░░  ░░░░    ░░░░░░░░░░                                  
                        ████████                                                                  ░░                  ░░                                  
                ████████                                                                                                              ░░░░  ▒▒  ░░░░░░    
                ░░░░░░                                                                                                                    ░░▒▒  ░░  ░░    
                  ▒▒▒▒▒▒▒▒▒▒▒▒▒▒▒▒▒▒▒▒▒▒▒▒▒▒▒▒▒▒▒▒▒▒▒▒▒▒▒▒▒▒▒▒▒▒▒▒▒▒▒▒▒▒▒▒▒▒▒▒▒▒▒▒▒▒▒▒▒▒▒▒▒▒▒▒▒▒▒▒▒▒▒▒▒▒▒▒▒▒▒▒▒▒▒▒▒▒▒▒▒▒▒▒▒▒▒▒░░      ▒▒░░░░░░  ▒▒        
                  ▒▒▒▒▒▒▒▒▒▒▒▒▒▒▒▒▒▒▒▒▒▒▒▒▒▒▒▒▒▒▒▒▒▒▒▒▒▒▒▒▒▒▒▒▒▒▒▒▒▒▒▒▒▒▒▒▒▒▒▒▒▒▒▒▒▒▒▒▒▒▒▒▒▒▒▒▒▒▒▒▒▒▒▒▒▒▒▒▒▒▒▒▒▒▒▒▒▒▒▒▒▒▒▒▒▒▒▒░░        ░░  ▒▒  ░░        
