
███████  ██████  ██    ██ ███████ ████████ ██████   █████   ██████ ████████ ██  ██████  ███    ██ 
██      ██    ██ ██    ██ ██         ██    ██   ██ ██   ██ ██         ██    ██ ██    ██ ████   ██ 
███████ ██    ██ ██    ██ ███████    ██    ██████  ███████ ██         ██    ██ ██    ██ ██ ██  ██ 
     ██ ██    ██ ██    ██      ██    ██    ██   ██ ██   ██ ██         ██    ██ ██    ██ ██  ██ ██ 
███████  ██████   ██████  ███████    ██    ██   ██ ██   ██  ██████    ██    ██  ██████  ██   ████ 
                                                                                                  