
 _______ .__   __.   _______  __       __       _______. __    __  
|   ____||  \ |  |  /  _____||  |     |  |     /       ||  |  |  | 
|  |__   |   \|  | |  |  __  |  |     |  |    |   (----`|  |__|  | 
|   __|  |  . `  | |  | |_ | |  |     |  |     \   \    |   __   | 
|  |____ |  |\   | |  |__| | |  `----.|  | .----)   |   |  |  |  | 
|_______||__| \__|  \______| |_______||__| |_______/    |__|  |__| 
                                                                   
