                                                                                                                                                                            
                                                                                                                
                                                                                                                
                ██▒▒▒▒▒▒▒▒▒▒▒▒▒▒▒▒▒▒▒▒▒▒▒▒▒▒▒▒▒▒▒▒▒▒▒▒▒▒▒▒▒▒▒▒▒▒▒▒▒▒▒▒▒▒▒▒▒▒▒▒▒▒▒▒▒▒▒▒▒▒▒▒▓▓                    
              ▒▒                                                                          ▒▒                    
              ▒▒                                                                          ▒▒                    
              ▒▒                                                                          ▒▒                    
              ▒▒                                                                          ▒▒                    
              ▒▒                                                                          ▒▒                    
              ▒▒                                                                          ▒▒                    
              ▒▒                                                                          ▒▒                    
              ▒▒                                                                          ▒▒            
              ▒▒                                                                          ▒▒                 
              ▒▒                                                                          ▒▒                    
              ▒▒                                                                          ▒▒                    
              ▒▒                                                                          ▒▒                    
              ▒▒                                                                          ▒▒                    
              ▒▒                                                                          ▒▒                    
              ▒▒                                                                          ▒▒                    
              ▒▒                                                                          ▒▒                    
              ▒▒                                                                          ▒▒                    
              ▒▒                                                                          ▒▒                    
              ▒▒                                                                          ▓▓                    
                ░░░░░░░░░░░░░░░░░░░░░░░░░░░░░░░░░░░░░░░░░░░░░░░░░░░░░░░░░░░░░░░░░░░░░░░░░░░░                    
                                                                                                                                                                
                                                                                                                
                                                                                                                
