     ___       _______   _______   __  .___________. __    ______   .__   __. 
    /   \     |       \ |       \ |  | |           ||  |  /  __  \  |  \ |  | 
   /  ^  \    |  .--.  ||  .--.  ||  | `---|  |----`|  | |  |  |  | |   \|  | 
  /  /_\  \   |  |  |  ||  |  |  ||  |     |  |     |  | |  |  |  | |  . `  | 
 /  _____  \  |  '--'  ||  '--'  ||  |     |  |     |  | |  `--'  | |  |\   | 
/__/     \__\ |_______/ |_______/ |__|     |__|     |__|  \______/  |__| \__| 
                                                                              