
                                                                                                                                                                   
                                    &@@@@@ @                                    
                                    @@@@@@@@@@(                                 
                                   .@@@@@@@@@@@@@   .                           
                              (@@@@@@@@@@@@@@@@@@@@@@*                          
                    @@@      ,@@@@@@@@@@@@@@@@@@@@@@@@@@@@@@(                   
                     @@@@@@@@@@@@@@@@@@@@@@@@@@@@@@@@@@@@@@@@@@@@.              
           @@@       @@@@@@@@@@@@@@@@@@@@@@@@@@@@@@@@@@@@@@@@@@@@@@@            
     @@@@@@@@@@@@@@@@@@@@@@@@@@@@@@@@@@@@@@@@@@@@@@@@@@@@@@@@@@@@@,             
      %%@@@@@@@@@@@@@@@@@@@@@@@@@@@@@@@@@@@@@@@@@@@@@@@@@@@@@@@@@@              
           (@@@@@@@@@@@@@@@@@@@@@@@@@@@@@@@@@@@@@@@@@@@@@@@@@@@@@(              
                @@@@@@@@@@@@@@@@@@@@@@@@@@@@@@@@@@@@@@@@@@@@@@.                 
                   @@@@@@@@@@@@@@@@@@@@@@@@@@@@@@@@@@@@@@@@@@.                  
                   @@@@@@@@@@@@@@@@@@@@@@@@@@@@@@@@@@@@@@@@/                    
                     /@@@@@@@@@@@@@@@@@@@@@@@@@@@@@@@@@@@@@@@@                  
                      *@@@@@@@@@@@@@@@@@@@@@@@@@@@@@@@@@@@@@@@@                 
                       (@@@@@@@@@@@@@@@@@@@@@@@@@@@@@@@@@@@@@@@                 
                       @@@@@@@@@@@@@@@@@@@@@@@@@@@@@@@@@@@@@@@@,                
                      .@@@@@@@@@@@@@@@@@@@@@@@@@@@@@@@@@@@@@@@                  
                      (@@@@@@@@@@@@@@@@@@@@@@@@@@@@@@@@@@@@@@@                  
                      @@@@@@@@@@@@@@@@@@@@@@@@@@@@@@@@@@@@@@@@@@                
                      @@@@@@@@@@@@@@@@@@@@@@@@@@@@@@@@@@@@@@@@@@@               
                     @@@@@@@@@@@@@@@@@@@@@@@@@@    @@@@@@@@@@@                  
                     /&@@@@@@@@@@@@@@@@@@@@@              ,                     
                            *      @@@@@@@@.                             @@     
                                                                       @@@@     
                                                                       #@@@     
                                                                        @@      
                                                                                
                                                                                