 __       _______     _______.   .___  ___.  _______     _______. __    __  .______       _______     _______.
|  |     |   ____|   /       |   |   \/   | |   ____|   /       ||  |  |  | |   _  \     |   ____|   /       |
|  |     |  |__     |   (----`   |  \  /  | |  |__     |   (----`|  |  |  | |  |_)  |    |  |__     |   (----`
|  |     |   __|     \   \       |  |\/|  | |   __|     \   \    |  |  |  | |      /     |   __|     \   \    
|  `----.|  |____.----)   |      |  |  |  | |  |____.----)   |   |  `--'  | |  |\  \----.|  |____.----)   |   
|_______||_______|_______/       |__|  |__| |_______|_______/     \______/  | _| `._____||_______|_______/    
                                                                                                              