                                                                                                                                                                            
                                                                                                     
              ██▒▒▒▒▒▒▒▒▒▒▒▒▒▒▒▒▒▒▒▒▒▒▒▒▒▒▒▒▒▒▒▒▒▒▒▒▒▒▒▒▒▒▒▒▒▒▒▒▒▒▓▓                    
              ▒▒                                                  ▒▒                    
              ▒▒                                                  ▒▒                    
              ▒▒                                                  ▒▒                    
              ▒▒                                                  ▒▒                    
              ▒▒                                                  ▒▒                    
              ▒▒                                                  ▒▒                    
              ▒▒                                                  ▒▒                    
              ▒▒                                                  ▒▒            
              ▒▒                                                  ▒▒                 
              ▒▒                                                  ▒▒                    
              ▒▒                                                  ▒▒                    
              ▒▒                                                  ▒▒                    
              ▒▒                                                  ▒▒                    
              ▒▒                                                  ▒▒                    
              ▒▒                                                  ▒▒                    
              ▒▒                                                  ▒▒                    
              ▒▒                                                  ▒▒                    
              ▒▒                                                  ▒▒                    
              ▒▒                                                  ▒▒                    
              ▓▓░░░░░░░░░░░░░░░░░░░░░░░░░░░░░░░░░░░░░░░░░░░░░░░░░░▓▓                    
                                                                                                                                                                
                                                                                                                
                                                                                                                
